اسم	jina
مع	na
هو	ni
هو	yeye
هي	yeye
هي	ake
سنة	mwaka
تعليق	maoni
سطر	mstari
كما	kama
عبد	mtumwa
التعداد	sensa
مساحة	uwanja
مساحة	nafasi
خارجية	nje
خريطة	ramani
قدم	mguu
القرن	pembe
القرن	karne
القدم	mguu
الكلية	chuo
الكلية	figo
المياه	maji
تحت	chini
رئيس	rais
رئيس	mkuu
رئيس	bosi
العمل	utendaji
العمل	kazi
الخريطة	ramani
الرسمي	rasmi
عشر	kumi
الدين	dini
الدين	deni
الاسم	jina
البحر	bahari
المملكة	ufalme
المملكة	eneo
جائزة	tuzo
نظام	mfumo
عقد	mkufu
عقد	mkataba
مارس	machi
مارس	mirihi
اليوم	leo
يناير	januari
اللغة	lugha
جنوب	kusini
كبير	kubwa
مايو	mei
فبراير	februari
يونيو	juni
يوليو	julai
شمال	kaskazini
سبتمبر	septemba
فريق	timu
ديسمبر	desemba
كبيرة	kubwa
الجيش	jeshi
نوفمبر	novemba
واحدة	moja
داخل	ndani
الدولي	kimataifa
بلدة	mji
الحكومة	serikali
متر	mita
حالة	hadhi
حالة	kesi
حالة	hali
مليون	milioni
الرئيس	rais
الرئيس	mkuu
الشمالية	kaskazini
يسار	kushoto
شرق	mashariki
وسط	katikati
الجهاز	kifaa
ثلاثة	tatu
صفحة	ukurasa
بلدية	manispaa
برنامج	programu
الجمهورية	jamhuri
الدولية	kimataifa
المقالة	makala
حركة	harakati
التعليم	elimu
لغة	lugha
الشرق	mashariki
جبل	mlima
الجزء	sehemu
مقالة	uandishi
مقالة	makala
شهر	mwezi
سلسلة	mfululizo
سلسلة	uzi
سلسلة	mnyororo
العلوم	sayansi
جمهورية	jamhuri
الدم	damu
وزارة	wizara
مستوى	kiwango
مختلفة	tofauti
تونس	tunisia
المجتمع	jamii
يتيمة	yatima
ثلاث	tatu
نهر	mto
عين	jicho
الماء	maji
غرب	magharibi
فوق	juu
العلم	sayansi
العلم	bendera
شخص	mtu
دولار	dola
الكبير	kubwa
فلسطين	palestina
مشروع	mradi
مكتب	ofisi
مكتب	dawati
جنس	ngono
عنوان	anwani
الشمس	jua
جزء	sehemu
روسيا	mrusi
روسيا	urusi
القانون	sheria
الشمال	kaskazini
هم	wao
قانون	sheria
كلمة	neno
حكومة	serikali
الخليج	ghuba
مصدر	chanzo
خارج	nje
ثورة	mapinduzi
حقوق	haki
الجنوب	kusini
وزير	waziri
مسجد	msikiti
جزر	karoti
يد	mkono
قوة	nguvu
قوة	kani
قوة	madaraka
نظرية	nadharia
قاعدة	msingi
قاعدة	sharti
البحرين	bahrain
المسيحية	mkristo
المسيحية	ukristo
الكنيسة	kanisa
الدفاع	ulinzi
شبكة	mtandao
نصف	nusu
المستخدم	mtumiaji
رواية	riwaya
المسجد	msikiti
طائرة	randa
طائرة	ndege
مسلسلات	mfululizo
البلدية	manispaa
الحالة	hadhi
الحالة	hali
الحالة	kesi
توضيح	ufafanuzi
توضيح	fasiri
مملكة	ufalme
مملكة	eneo
مرض	ugonjwa
الجسم	mwili
الثقافة	utamaduni
الطب	dawa
قبيلة	kabila
لجنة	kamati
عشرة	kumi
قائد	kiongozi
قائد	amiri
جهاز	kifaa
مستخدم	tumika
مستخدم	mtumiaji
البيانات	data
هولندا	uholanzi
اللجنة	kodi
اللجنة	kamati
القلب	moyo
بيانات	data
ظهر	nyuma
باب	mlango
خمسة	tano
علاقة	uhusiano
كامل	zima
كامل	kamili
السودان	sudan
كنيسة	kanisa
اليد	mkono
المحيط	bahari
النهائي	mwisho
الغرب	magharibi
جريدة	gazeti
بالقرب	karibu
الخدمة	huduma
عمدة	meya
كوريا	kikorea
كوريا	korea
قلعة	ngome
فكرة	wazo
لعبة	mchezo
لون	rangi
الموسيقى	muziki
ليبيا	libya
جمال	uzuri
ثقافة	utamaduni
المتوسط	wastani
الهواء	hewa
علوم	sayansi
اليونان	ugiriki
جيش	jeshi
طالب	mwanafunzi
ساعة	tazama
ساعة	saa
القوة	nguvu
القوة	kani
القوة	madaraka
المالية	fedha
النقل	uhamisho
النقل	usafiri
النقل	beba
موسى	musa
تلفزيون	televisheni
النفس	binafsi
ثاني	pili
دولية	kimataifa
المرض	ugonjwa
المرض	maradhi
صوت	sauti
سوق	soko
المستوى	kiwango
اللون	rangi
صحيفة	gazeti
الشرطة	polisi
الساعة	saa
المثال	mfano
الهندسة	jiometri
الهندسة	uhandisi
الصحة	afya
الشمالي	kaskazini
القارة	bara
الانتخابات	uchaguzi
متحف	makumbusho
الفن	sanaa
حل	tatua
حل	suluhisho
نائب	naibu
البيئة	mazingira
الاقتصاد	uchumi
القمر	mwezi
الصوت	sauti
العين	jicho
موسيقى	muziki
التجارة	biashara
ظل	kivuli
الخدمات	ibada
الخدمات	huduma
النسخة	toleo
الشاعر	mshairi
القدرة	uwezo
القدرة	ujazo
البلدة	mji
وجه	uso
السياسة	sera
السياسة	siasa
مكتبة	maktaba
الجبل	mlima
قرب	karibu
الخط	mstari
وخاصة	hasa
النار	moto
جغرافيا	jiografia
رمضان	ramadhani
خدمة	huduma
هندسة	jiometri
هندسة	uhandisi
ملوك	wafalme
ستة	sita
خمس	tano
مؤتمر	mkutano
واسع	pana
مياه	maji
مربع	boksi
مربع	mraba
السوق	soko
البرلمان	bunge
الوسط	katikati
الوضع	hadhi
الوضع	hali
البرتغال	ureno
الجانب	upande
درس	somo
التربية	elimu
التعاون	ushirikiano
التعاون	bia
كمية	kiasi
قطاع	sekta
تعلم	kujifunza
تعلم	funza
وراء	nyuma
اقتصاد	uchumi
مستشفى	hospitali
خلف	nyuma
العلاقة	uhusiano
طب	dawa
حساب	akaunti
حساب	kadiri
الفرقة	bendi
المصدر	chanzo
سلة	kikapu
المريض	mgonjwa
غزة	gaza
الكون	ulimwengu
التنمية	maendeleo
حملة	kampeni
برج	mnara
المال	fedha
القاعدة	msingi
القاعدة	sharti
الديمقراطية	demokrasia
الشبكة	wavu
الشبكة	mtandao
النفط	mafuta
الدورة	mzunguko
اكتشاف	gundua
اكتشاف	ugunduzi
المؤسسة	msingi
المؤسسة	taasisi
نجم	nyota
الفصل	sura
الفصل	daraja
الكاثوليكية	mkatoliki
الكاثوليكية	ukatoliki
الاستقلال	uhuru
البيت	maskani
البيت	nyumba
بذرة	mbegu
قلب	moyo
مثال	mfano
النجم	nyota
الحقوق	haki
فن	sanaa
الطعام	chakula
الكرة	mpira
انتخابات	uchaguzi
علمية	kisayansi
الاتصالات	mawasiliano
محتوى	maudhui
رئاسة	urais
الدستور	katiba
التقنية	teknolojia
الجلد	ngozi
الجلد	gamba
الوزن	uzito
تعليم	funzo
تعليم	elimu
سيارة	gari
النظرية	nadharia
ليلة	usiku
حجة	hoja
المهمة	misheni
الجنس	ngono
كمال	ukamilifu
مؤسس	mwanzilishi
المزيد	zaidi
البابا	papa
قدرة	uwezo
المتحف	makumbusho
مساعد	msaidizi
اثنين	mbili
سيف	upanga
شاعر	mshairi
العلامة	alama
منزل	maskani
منزل	nyumba
معنى	maana
حاول	jaribu
الجبهة	mbele
الحرية	uhuru
سم	sumu
النصر	ushindi
النصف	nusu
سلاح	silaha
ذهب	dhahabu
النمسا	austria
الداخلي	ndani
السياحة	utalii
جسم	mwili
جسم	pinga
اليهودية	kiyahudi
اليهودية	uyahudi
الحملة	kampeni
الرياضيات	hisabati
رسمية	rasmi
اللاتينية	kilatini
النهر	mto
الصينية	kichina
العودة	rudia
العودة	nyuma
الطبعة	toleo
القومية	utaifa
تقويم	kalenda
الذاكرة	kumbukumbu
سبعة	saba
رئيسية	kuu
شمس	jua
جسر	daraja
غرفة	chumba
الفلسفة	falsafa
الفيزياء	fizikia
المكتب	dawati
المكتب	ofisi
الباب	mlango
الجمعة	ijumaa
القطاع	sekta
الفعل	kitenzi
الفعل	igizo
اليونانية	kigiriki
مقال	uandishi
مقال	makala
ابنة	binti
الخارج	nje
اتجاه	mwelekeo
بنية	hudhurungi
بنية	muundo
الكيمياء	kemia
صحة	afya
قاعة	ukumbi
النووية	nyuklia
زوجة	mke
الحجر	jiwe
خليج	ghuba
السلسلة	mfululizo
السلسلة	uzi
السلسلة	mnyororo
المكتبة	maktaba
ماء	maji
حفل	sherehe
التربة	udongo
مسيحية	mkristo
مسيحية	ukristo
الصدر	kifua
الصدر	maziwa
فلسفة	falsafa
الهجرة	uhamiaji
الجيل	kizazi
الوادي	bonde
شجرة	mti
بيئة	mazingira
الذهب	dhahabu
كيمياء	kemia
كوكب	sayari
ثمانية	nane
حرية	uhuru
فيزياء	fizikia
المشتري	mnunuzi
المشتري	mshtarii
تقييم	upimaji
تقييم	tathmini
الاجتماع	mkutano
الوجه	uso
الحضارة	ustaarabu
الكهرباء	umeme
المعارضة	upinzani
عدا	isipokuwa
كيميائية	kemikali
وزن	uzito
وظيفة	kazi
موسيقي	mwanamuziki
موسيقي	muziki
دولي	kimataifa
البنك	benki
سلامة	usalama
عضوية	uanachama
عضوية	hai
التقويم	kalenda
الهاتف	simu
الشعار	nembo
بنك	benki
ملكة	malkia
قصيدة	shairi
الغذاء	chakula
الخطاب	hotuba
اكثر	zaidi
زاوية	kona
معبد	hekalu
العدو	adui
جندي	askari
الشهر	mwezi
الكبد	ini
مسار	mkondo
مسار	njia
ايضا	pia
ايضا	sana
سبع	saba
المحتوى	maudhui
الداخل	ndani
التعلم	kujifunza
التعلم	funza
فندق	hoteli
الدواء	dawa
العنوان	anwani
خصوصا	hasa
رسمي	rasmi
الجهد	juhudi
العضوية	uanachama
العضوية	hai
الفم	mdomo
جيل	kizazi
التحالف	muungano
التنفيذي	mtendaji
الاستعمار	ukoloni
الجغرافية	jiografia
الشيوعي	mkomunisti
الزوج	mume
الديانة	dini
الرياح	upepo
تنمية	maendeleo
اليسار	kushoto
العدل	haki
نيسان	aprili
فيروس	virusi
زهرة	ua
الوزير	waziri
شرقي	mashariki
السلاح	silaha
تجارة	biashara
الملوك	wafalme
سد	bwawa
الفئة	kategoria
الفئة	daraja
باستثناء	isipokuwa
زعيم	kiongozi
زعيم	bosi
المعادن	madini
استقلال	uhuru
هيكل	muundo
حضارة	ustaarabu
رياضيات	hisabati
تكنولوجيا	teknolojia
تيار	mkondo
تيار	kijito
النمط	taratibu
النمط	mtindo
قابلة	mkunga
دستور	katiba
العدالة	haki
الغزو	uvamizi
الصيد	uvuvi
الصيد	uwindaji
اول	kwanza
الاشتراكية	ujamaa
تموز	julai
اجتماع	mkutano
شكرا	asante
تدمير	haribu
تدمير	uharibifu
حوار	mazungumzo
المعنى	maana
جهد	juhudi
العظم	mfupa
التكنولوجيا	teknolojia
غينيا	guinea
مصنع	kiwanda
مصنع	mtengenezaji
الروح	roho
ذاكرة	kumbukumbu
التمييز	ubaguzi
غزو	uvamizi
المعدنية	madini
السياسات	sera
السياسات	siasa
عشرين	ishirini
طفل	kitoto
طفل	mtoto
غربي	magharibi
جملة	sentensi
الصوديوم	sodiamu
الاتجاه	mwelekeo
الشهرة	umaarufu
الرئاسة	urais
التحقيق	uchunguzi
التحقيق	dahili
طائر	ndege
مغني	mwimbaji
داء	ugonjwa
تمثال	kinyago
تمثال	sanamu
تحالف	muungano
مهندس	mhandisi
فضاء	nafasi
السبت	jumamosi
القطن	pamba
حزيران	juni
النسبة	uwiano
بطاقة	kadi
روك	mwamba
موجة	wimbi
القبيلة	kabila
مركبة	gari
شمالي	kaskazini
مقابلة	mahojiano
الصومال	somalia
الخميس	alhamisi
مغنية	mwimbaji
الجهاد	jihadi
اقترح	pendekeza
دفاع	ulinzi
كلام	hotuba
كلام	ongea
زيت	mafuta
الرجاء	tafadhali
الضرائب	kodi
التطوير	maendeleo
تسعة	tisa
زوج	mume
النحاس	shaba
جنوبي	kusini
التغذية	lishe
المعدة	tumbo
سر	siri
الباردة	baridi
الجسر	daraja
البرج	mnara
الوظيفة	kazi
قارة	bara
البروتين	protini
اليوناني	kigiriki
صاروخ	roketi
صاروخ	kombora
حادث	mkasa
حادث	ajali
سعر	bei
كيميائي	kemikali
كيميائي	mwanakemia
جراحة	upasuaji
قبر	kaburi
لحم	nyama
الان	sasa
الزرقاء	bluu
هجرة	uhamiaji
جمعة	ijumaa
المعبد	hekalu
الطوارئ	dharura
طبعة	toleo
الغرفة	chumba
جدار	ukuta
البذور	mbegu
انفجار	mlipuko
الهوية	utambulisho
مبكر	mapema
المساهمة	mchango
الحل	suluhisho
البطن	tumbo
صيد	uwindaji
الجدار	ukuta
السلع	bidhaa
ثلاثين	thelathini
الورق	karatasi
الكورية	kikorea
السكري	kisukari
انتخاب	uchaguzi
الفائز	mshindi
قمر	mwezi
مزيد	zaidi
الميناء	kituo
الميناء	bandari
نيجيريا	nigeria
الزجاج	kioo
المرور	trafiki
الجليد	barafu
الحكومات	serikali
الاستثمار	wekeza
الاستثمار	uwekezaji
الميزانية	bajeti
الذيل	mkia
معارضة	upinzani
مساء	jioni
القمح	ngano
شك	shaka
الجمال	uzuri
المبكر	mapema
ابريل	aprili
قومية	utaifa
الربع	robo
البرتغالي	kireno
شباط	februari
الساق	mguu
الانفجار	kilipuzi
الانفجار	mlipuko
الكوكب	sayari
المصطلحات	istilahi
مروحية	helikopta
خطوة	hatua
فقرة	aya
المخاطر	hatari
توليد	kizazi
توليد	zalisha
دم	damu
الدهون	mafuta
البول	mkojo
الموجة	wimbi
السد	bwawa
ميزانية	bajeti
موريتانيا	mauritania
البعثة	misheni
زواج	ndoa
زواج	harusi
راديو	redio
خبر	habari
الصليب	msalaba
دينار	dinari
الشيوعية	mkomunisti
الشيوعية	ukomunisti
الذات	binafsi
رخصة	leseni
جغرافية	jiografia
الاحتجاجات	maandamano
الجراحة	upasuaji
تمييز	ubaguzi
المفهوم	dhana
مختبر	maabara
ملابس	nguo
الفقر	umaskini
كعب	kisigino
السهل	rahisi
الثلاثاء	jumanne
القصيدة	shairi
الملح	chumvi
الثلج	theluji
الثلج	barafu
مزرعة	shamba
سنه	mwaka
معلم	bwana
معلم	mwalimu
البضائع	bidhaa
السفارة	ubalozi
اثنان	mbili
الدبلوماسية	kidiplomasia
الدبلوماسية	diplomasia
تاج	taji
الطور	awamu
انتصار	ushindi
حصان	farasi
مستشار	diwani
مستشار	mshauri
الاثنين	jumatatu
الصفر	sifuri
الخطوة	hatua
سفارة	ubalozi
الكلى	figo
المنطق	mantiki
الفرات	frati
مكعب	mchemraba
السلامة	usalama
منصة	jukwaa
خميس	alhamisi
الطائر	ndege
احد	mtu
احد	moja
الحكمة	hekima
شمالا	kaskazini
مشهور	maarufu
مشهور	maalum
القضاة	waamuzi
الخبز	mkate
تعاون	ushirikiano
تعاون	shirikiana
تعاون	bia
الفيروس	virusi
الجملة	sentensi
الدقة	usahihi
السفير	balozi
الشاي	chai
مطر	mvua
نووية	nyuklia
فيتامين	vitamini
العسل	asali
عبادة	uabudiwaji
عبادة	ibada
الفطريات	kuvu
الجندي	askari
نجمة	nyota
العقيد	kanali
بروتين	protini
الزيت	mafuta
كوري	kikorea
هواء	hewa
اللسان	ulimi
تسع	tisa
ثانيا	pili
العبد	mtumwa
السيف	upanga
مرشح	kichujio
مرشح	mgombea
دواء	dawa
رجاء	tafadhali
حزام	ukanda
سفير	balozi
الكاميرا	kamera
الظلام	eusi
الظلام	giza
ملخص	muhtasari
فعلا	kweli
وفد	ujumbe
مبيعات	mauzo
القهوة	kahawa
سكر	sukari
تمويل	fedha
نار	moto
برلمان	bunge
ضعيفة	dhaifu
خمسين	hamsini
نووي	nyuklia
ويست	magharibi
صالة	ukumbi
عظم	mfupa
المبيعات	mauzo
تاون	mji
قطار	treni
شرط	hali
القابلة	mkunga
نوح	nuhu
داخلي	ndani
محلول	suluhisho
الرمال	mchanga
هرمون	homoni
الحليب	maziwa
القطار	treni
البرتغالية	kireno
القلق	wasiwasi
ليل	usiku
الفضة	fedha
البروتستانتية	uprotestanti
البروتستانتية	mprotestanti
الجغرافيا	jiografia
الفقرة	aya
المنصة	jukwaa
المنصة	ukumbi
الفندق	hoteli
قاموس	kamusi
التحقيقات	uchunguzi
طبق	sahani
الثلاثين	thelathini
التقييم	upimaji
التقييم	tathmini
عادي	kawaida
الحصان	farasi
القطر	kipenyo
غانا	ghana
الكوري	kikorea
ورق	karatasi
كينيا	kenya
الحرير	hariri
الجسد	mwili
التمرد	fitina
التمرد	uasi
ديمقراطية	demokrasia
المزمن	sugu
الوريد	mshipa
مجزرة	mauaji
احتمالية	uwezekano
سقف	dari
سقف	paa
بركة	kidimbwi
بركة	bwawa
الغنية	tajiri
جنوبية	kusini
قط	paka
نورث	kaskazini
فضية	fedha
بوصة	inchi
المولد	jenereta
عينة	sampuli
النحل	nyuki
غابة	mwitu
غابة	msitu
المطر	mvua
ذراع	mkono
كونت	hesabu
خارطة	ramani
مبكرة	mapema
كلب	mbwa
الفك	taya
ساق	mguu
المصنع	kiwanda
المصنع	mtengenezaji
المساعد	msaidizi
ضعيف	dhaifu
السنغال	senegal
الراديو	redio
الكلب	mbwa
الهرم	piramidi
القيامة	ufufuo
ذيل	mkia
الغضب	hasira
شرقية	mashariki
مجددا	tena
تربة	udongo
رائحة	harufu
المؤسس	mwanzilishi
التاج	taji
البوتاسيوم	potasiamu
حيز	nafasi
بنغلاديش	bangladesh
فقر	umaskini
غربية	magharibi
العينة	sampuli
رب	bwana
حمى	homa
مولد	jenereta
كهرباء	umeme
اللحوم	nyama
ترخيص	leseni
منتظمة	kawaida
مشاعر	hisia
جسد	mwili
عاصفة	dhoruba
ممتاز	bora
عربة	mkokoteni
عربة	gari
صيني	kichina
الفيلسوف	mwanafalsafa
العبادة	ibada
الدعاية	utangazaji
الدعاية	propaganda
الحظ	bahati
المثلث	pembetatu
القولون	koloni
المفتاح	ufunguo
الدراجة	baiskeli
لوك	luka
سلك	waya
رياح	upepo
مثلث	pembetatu
طعام	chakula
السر	siri
ابراهيم	ibrahim
عقدة	fundo
الثمن	bei
الركن	kona
اغسطس	agosti
المواصلات	usafiri
المواصلات	beba
تنس	tenisi
الامن	usalama
فيل	tembo
الحاجز	kizuizi
اللبن	maziwa
الريح	upepo
مدرس	mwalimu
يوناني	kigiriki
الجد	babu
مذبحة	mauaji
مذبحة	chinja
الحبل	kamba
حجرة	chumba
جلد	ngozi
جلد	gamba
نافذة	dirisha
سرقة	ujambazi
سرقة	wizi
بلو	bluu
هرم	piramidi
الرمل	mchanga
الفيل	tembo
فالي	bonde
قضاة	waamuzi
ماثيو	mathayo
الترفيه	burudani
دبلوماسية	kidiplomasia
دبلوماسية	diplomasia
المحاسبة	uhasibu
يونانية	kigiriki
دماء	damu
المغني	mwimbaji
المحيطات	bahari
المشاعر	hisia
ركن	kona
الاستاذ	profesa
الكرامة	heshima
الكتف	bega
القط	paka
بركان	volkano
بنين	benin
اغنية	wimbo
مصرف	benki
قبله	busu
الصانع	mtengenezaji
زر	kitufe
ليلا	usiku
حريق	moto
ذروة	kilele
التنبؤ	utabiri
المشرف	msimamizi
التبغ	tumbaku
الظل	kivuli
ثمان	nane
السجل	rekodi
السجل	sajili
السجل	gogo
التحدي	changamoto
البقرة	ng'ombe
اربع	nne
المليون	milioni
التهديد	tishio
جلدية	ngozi
تلفاز	televisheni
حقن	sindano
ساوث	kusini
بالضبط	hasa
النيتروجين	nitrojeni
زرقاء	bluu
منطق	mantiki
الملاك	malaika
ضريبة	kodi
المبلغ	kiasi
المبلغ	jumla
تنزانيا	mtanzania
تنزانيا	tanzania
الكهف	pango
الروك	mwamba
المختبر	maabara
التمريض	uuguzi
كاميرا	kamera
بارد	baridi
ريفر	mto
هاوس	nyumba
شخصيا	binafsi
الحجاب	hijabu
الحجاب	pazia
ذهبي	dhahabu
وزيرة	waziri
السلك	waya
عنق	shingo
ملح	chumvi
الدجاج	kuku
السعر	bei
التذاكر	tiketi
الزنك	zinki
الورقة	karatasi
التنس	tenisi
ضفدع	chura
المساء	jioni
تعاليم	mafundisho
فدان	ekari
الكمال	ukamilifu
هوك	ndoano
فضة	fedha
السلف	mtangulizi
اربعة	nne
المؤمن	muumini
جثة	mwili
جثة	kaputi
جزيء	molekuli
المواطنة	uraia
عريض	pana
كهف	pango
المصرف	benki
الانتصار	ushindi
مختلفين	tofauti
صدمة	mshtuko
عصفور	ndege
عصفور	shomoro
ببطء	polepole
القبر	kaburi
تاجر	mfanyabiashara
مؤامرة	njama
حليب	maziwa
الاكتشاف	ugunduzi
مذيع	mtangazaji
الكوميدي	mchekeshaji
الاستثمارات	uwekezaji
ملاك	malaika
الدخان	moshi
الزهري	kaswende
خبز	mkate
العاصفة	dhoruba
مربعة	mraba
التمثال	sanamu
فارغة	tupu
انجلترا	uingereza
الخنزير	nguruwe
ستين	sitini
القماش	nguo
بقعة	doa
الرقبة	shingo
المزرعة	shamba
الطماطم	nyanya
حافلة	basi
لورد	bwana
معاناة	mateso
قلادة	mkufu
برميل	pipa
الحقن	sindano
المظهر	muonekano
لاتينية	kilatini
الممتلكات	mali
مصباح	taa
عقيد	kanali
السقف	dari
السقف	paa
المثلية	ushoga
الحائط	ukuta
التميز	ubora
عطلة	likizo
ديانة	dini
الحمى	homa
مظاهرة	maandamano
الراعي	mchungaji
الراعي	mfadhili
عدو	adui
الجوع	njaa
خريج	mhitimu
البلاستيك	plastiki
سنتيمتر	sentimita
الهندوسية	uhindu
الغد	kesho
المهبل	uke
الشرط	sharti
الشرط	hali
الصخرة	mwamba
صخرة	mwamba
ناميبيا	namibia
القاموس	kamusi
فم	mdomo
مجهود	juhudi
ثري	tajiri
قلق	wasiwasi
الحلو	tamu
جمل	ngamia