dan	na
dengan	na
tahun	mwaka
sebagai	kama
juga	pia
bagian	upande
bagian	sehemu
orang	mtu
luar	nje
mereka	wao
satu	moja
kota	mji
kota	jiji
lebih	zaidi
nama	jina
pertama	awali
pertama	kwanza
bahasa	lugha
besar	kubwa
besar	kuu
dia	yeye
genus	jenasi
daftar	orodha
barat	magharibi
timur	mashariki
dua	mbili
selatan	kusini
kingdom	ufalme
september	septemba
mei	mei
anak	mtoto
lagu	wimbo
utara	kaskazini
daerah	wilaya
daerah	uwanja
daerah	eneo
daerah	kaunti
daerah	upande
air	maji
air	hewa
album	albamu
kedua	pili
tengah	katikati
team	timu
utama	kuu
bulan	mwezi
departemen	idara
resmi	rasmi
udara	hewa
tetapi	lakini
sekarang	sasa
rumah	maskani
rumah	nyumba
pendidikan	elimu
tim	timu
sistem	mfumo
seed	mbegu
batang	shina
oktober	oktoba
matahari	jua
presiden	rais
tiga	tatu
musik	muziki
planet	sayari
menteri	karani
menteri	waziri
lagi	tena
lagi	zaidi
april	aprili
data	data
islam	uislamu
artikel	makala
tanduk	pembe
kerajaan	ufalme
abad	karne
perusahaan	kampuni
perusahaan	tajiri
style	mtindo
januari	januari
maret	machi
bola	mviringo
bola	mpira
pemerintah	serikali
setiap	ote
setiap	o-ote
setiap	kila
juni	juni
sungai	mto
desember	desemba
agustus	agosti
international	kimataifa
internasional	kimataifa
sumber	chanzo
sejarah	historia
gereja	kanisa
dasar	msingi
diri	binafsi
november	novemba
program	programu
pesawat	randa
pesawat	ndege
juli	julai
akhirnya	hatimaye
jika	kama
februari	februari
proses	mchakato
dekat	funga
dekat	karibu
versi	toleo
pemerintahan	serikali
republik	jamhuri
suku	kabila
suara	sauti
pengguna	mtumiaji
luas	pana
luas	uwanja
korea	kikorea
korea	korea
agama	dini
anda	wewe
saja	tu
museum	makumbusho
hukum	sheria
bangsa	taifa
tapi	lakini
gunung	mlima
meskipun	ingawa
berbeda	tofauti
berbeda	hitilafu
bintang	nyota
ibu	mama
tingkat	kiwango
kereta	treni
ruang	chumba
ruang	nafasi
empat	nne
ekonomi	uchumi
ekonomi	kiuchumi
api	moto
ilmiah	kisayansi
history	historia
kita	sisi
bekerja	kazi
asia	asia
kaki	mguu
website	tovuti
makanan	chakula
putri	binti
biasa	kawaida
tubuh	mwili
juta	milioni
televisi	televisheni
lisensi	leseni
khusus	mila
khusus	maalum
juara	bingwa
rusia	mrusi
rusia	urusi
mata	jicho
bahkan	hata
distrik	wilaya
jaringan	mtandao
budaya	utamaduni
lima	tano
teknologi	teknolojia
penyanyi	mwimbaji
australia	australia
seni	sanaa
badan	mwili
badan	idara
yunani	kigiriki
yunani	ugiriki
kini	sasa
pasar	soko
gambar	picha
gambar	taswira
gambar	mchoro
bank	benki
band	bendi
guru	bwana
guru	mwalimu
kawasan	uwanja
kawasan	eneo
kerja	kazi
jauh	mbali
radio	redio
sultan	sultani
selalu	daima
pemimpin	kiongozi
you	wewe
permainan	mchezo
warna	rangi
depan	mbele
menulis	andika
menulis	maandishi
contoh	sampuli
contoh	mfano
contoh	matumizi
belakang	nyuma
bunga	ua
lembaga	taasisi
masjid	msikiti
hutan	mwitu
hutan	msitu
tertentu	fulani
mobil	gari
mobil	motokaa
jam	saa
kantor	ofisi
tangan	mkono
music	muziki
gerakan	harakati
alkitab	biblia
tugas	kazi
seri	mfululizo
kekuatan	nguvu
kekuatan	madaraka
walaupun	ingawa
gaya	mtindo
final	mwisho
official	rasmi
kategori	kategoria
list	orodha
top	juu
perjalanan	abiri
perjalanan	safari
burung	ndege
sisi	upande
kami	sisi
garis	mstari
kesehatan	afya
mahasiswa	mwanafunzi
pengembangan	maendeleo
spider	buibui
soviet	sovieti
dinasti	nasaba
perkembangan	maendeleo
perkembangan	endelea
minggu	wiki
minggu	jumapili
kuno	kongwe
kuno	kale
paus	papa
paus	nyangumi
ratu	malkia
award	tuzo
meter	mita
proyek	mradi
teori	nadharia
tangga	ngazi
arah	mwelekeo
pribadi	binafsi
pribadi	faragha
menit	dakika
pohon	mti
kemampuan	uwezo
kemampuan	uhodari
keadaan	hali
berita	habari
berita	simulizi
perangkat	kifaa
kondisi	hali
senjata	silaha
senjata	bunduki
mudah	rahisi
rasa	ladha
layanan	ibada
layanan	huduma
one	moja
kimia	kemikali
kimia	kemia
enam	sita
rock	mwamba
ayah	baba
penyakit	ugonjwa
penyakit	maradhi
kasus	kesi
populer	maarufu
komunikasi	mawasiliano
istri	mke
emas	dhahabu
olahraga	mchezo
seseorang	mtu
seseorang	fulani
kebijakan	sera
struktur	muundo
oksigen	oksijeni
first	kwanza
edisi	toleo
laboratorium	maabara
hotel	hoteli
novel	riwaya
listrik	umeme
perdagangan	biashara
darah	damu
siswa	mwanafunzi
keuangan	fedha
kemungkinan	wezekana
kemungkinan	uwezekano
latin	kilatini
kebudayaan	utamaduni
kemerdekaan	uhuru
ukuran	ukubwa
kulit	ngozi
kulit	gamba
kendaraan	gari
pesan	ujumbe
pertengahan	katikati
pertahanan	ulinzi
pekerjaan	kazi
star	nyota
tujuh	saba
penumpang	abiria
minyak	mafuta
murid	mwanafunzi
generasi	kizazi
year	mwaka
series	mfululizo
khususnya	hasa
pinjaman	mkopo
pemenang	mshindi
tionghoa	kichina
polisi	polisi
penguasa	mtawala
pelabuhan	bandari
pelabuhan	kituo
jembatan	daraja
yayasan	msingi
keamanan	usalama
pendiri	mwanzilishi
news	habari
pintu	mlango
kiri	kushoto
austria	austria
jasa	ibada
jasa	huduma
bendera	bendera
pelayanan	ibada
pelayanan	huduma
pelayanan	wizara
kemenangan	ushindi
page	ukurasa
south	kusini
sini	hapa
west	magharibi
system	mfumo
biru	bluu
entertainment	burudani
kecuali	isipokuwa
candi	hekalu
calon	mgombea
harga	bei
pertemuan	mkutano
administrasi	utawala
dingin	baridi
north	kaskazini
dibawah	chini
meski	ingawa
kopi	kahawa
office	ofisi
hujan	mvua
makam	kaburi
size	ukubwa
parlemen	bunge
fisika	fizikia
miliar	bilioni
pernikahan	ndoa
pernikahan	harusi
company	kampuni
kuil	hekalu
house	nyumba
obat	dawa
kristus	kristo
lebar	upana
lebar	pana
song	wimbo
east	mashariki
menara	mnara
logo	nembo
daging	nyama
transportasi	usafiri
transportasi	beba
gitar	gitaa
peta	ramani
injil	injili
pabrik	kiwanda
network	mtandao
delapan	nane
telepon	ita
telepon	simu
bus	basi
college	chuo
musuh	adui
musuh	mtetea
pemberontakan	uasi
pemberontakan	fitina
revolusi	mapinduzi
kucing	paka
toko	duka
arti	maana
pelatih	kocha
penjualan	mauzo
line	mstari
kamu	wewe
society	jamii
pelajaran	somo
munisipalitas	manispaa
lintas	msalaba
project	mradi
angin	mpepea
angin	upepo
kuda	farasi
gelombang	wimbi
plat	sahani
kartu	kadi
wasit	mwamuzi
mark	alama
tepatnya	hasa
simbol	ishara
setengah	nusu
samping	upande
samping	kando
patung	kinyago
patung	sanamu
perpustakaan	maktaba
prajurit	askari
komunis	mkomunisti
ide	wazo
blue	bluu
kecelakaan	ajali
kecelakaan	anguka
pasir	mchanga
bapak	baba
membaca	soma
membaca	somo
tulang	mfupa
pakaian	nguo
art	sanaa
makhluk	kiumbe
sepuluh	kumi
riwayat	historia
ular	nyoka
ular	joka
sektor	sekta
pekerja	mfanyakazi
persatuan	umoja
matematika	hisabati
kontrak	mkataba
pelajar	mwanafunzi
kaya	tajiri
sun	jua
langkah	hatua
kesenian	sanaa
syarat	hali
ayam	kuku
portugal	ureno
pajak	kodi
space	nafasi
net	wavu
sensus	sensa
sembilan	tisa
pemilu	uchaguzi
adam	adamu
big	kubwa
gigi	jino
balai	ukumbi
eksekutif	mtendaji
kelapa	nazi
part	sehemu
telur	yai
filsafat	falsafa
biologi	biolojia
sudut	kona
rahasia	siri
gajah	tembo
service	huduma
komite	kamati
ekor	mkia
level	kiwango
kertas	karatasi
perak	fedha
persen	asilimia
anjing	mbwa
kampanye	kampeni
hall	ukumbi
lembah	bonde
dinding	ukuta
two	mbili
kalender	kalenda
mahkota	taji
musisi	mwanamuziki
perayaan	sherehe
dialek	lahaja
mil	maili
pedagang	mfanyabiashara
politikus	mwanasiasa
istimewa	maalum
gua	pango
edition	toleo
nuklir	nyuklia
rasul	mtume
konstitusi	katiba
senapan	bunduki
sapi	ng'ombe
kamar	chumba
ruangan	chumba
portugis	kireno
drum	ngoma
ilmuwan	mwanasayansi
pembunuhan	mauaji
rekor	rekodi
molekul	molekuli
night	usiku
kalimat	sentensi
situasi	hali
senior	mwandamizi
asisten	msaidizi
keju	jibini
runner	mkimbiaji
iman	imani
zat	dutu
basis	msingi
kompas	dira
dosen	mhadhiri
kolonel	kanali
virus	virusi
foundation	msingi
jari	kidole
paroki	parokia
demokrasi	demokrasia
makna	maana
kamera	kamera
susu	maziwa
duta	balozi
konferensi	mkutano
gula	sukari
kesatuan	umoja
town	mji
detik	pili
bakteri	bakteria
semangat	harara
semangat	roho
semangat	mvinyo
ton	tani
protein	protini
jantung	moyo
palestina	palestina
benua	bara
body	mwili
sepeda	baiskeli
suami	mume
normal	kawaida
musa	musa
siap	tayari
pangkalan	msingi
aman	salama
aman	madhubuti
profesor	profesa
warisan	urithi
biji	mbegu
sungguh	kweli
marah	hasira
hiburan	burudani
pangan	chakula
alamat	anwani
church	kanisa
kepolisian	polisi
special	maalum
ribu	elfu
kebebasan	uhuru
back	nyuma
now	sasa
natal	krismasi
library	maktaba
manajer	meneja
gagasan	wazo
samudra	bahari
mazmur	zaburi
statistik	takwimu
century	karne
salib	msalaba
manis	tamu
manis	utamu
sains	sayansi
pendeta	mhubiri
pendeta	padre
pendeta	mchungaji
letnan	luteni
ibadah	ibada
heart	moyo
sejarawan	mwanahistoria
beda	tofauti
pergerakan	harakati
topik	mada
federasi	shirikisho
teh	chai
march	machi
wajah	uso
pensiun	pensheni
television	televisheni
rapat	mkutano
takut	hofu
takut	cha
takut	chesha
kurikulum	mtaala
jadwal	ratiba
wangsa	nasaba
kaca	kioo
kue	keki
kolam	kidimbwi
kolam	bwawa
gold	dhahabu
budak	mtumwa
sabit	mundu
eve	hawa
substansi	dutu
harafiah	halisi
beribadah	ibada
botswana	botswana
finance	fedha
perburuan	uwindaji
barbados	barbados
kasihan	baya
kasihan	huruma
circuit	mzunguko
chin	kidevu
mirror	kioo
gabon	gabon
silahkan	tafadhali
atletik	riadha
alive	hai
togo	togo
holiday	likizo
topan	kimbunga
request	ombi
wedding	harusi
spot	doa
kreativitas	ubunifu
penghancuran	uharibifu
unggas	kuku
kimiawi	kemikali
penis	uume
shock	mshtuko
kronis	sugu
balok	boriti
miracle	muujiza
pool	bwawa
serdadu	askari
sandera	mateka
wife	mke
benin	benin
horn	pembe
harbour	bandari
tail	mkia
obor	mwenge
jihad	jihadi
purple	zambarau
kantung	mfuko
remember	kumbuka
sales	mauzo
gagak	kunguru
tea	chai
moses	musa
chemistry	kemia
speech	hotuba
narator	msimulizi
eight	nane
tenda	hema
tenggorokan	koo
kilat	umeme
timotius	timotheo
baptisan	ubatizo
tunggul	kisiki
kalium	potasiamu
window	dirisha
farm	shamba
rahang	taya
path	njia
pengasuh	mlezi
pengasuh	yaya
sense	maana
hitungan	hesabu
prediksi	agua
prediksi	utabiri
susun	panga
lesbian	msagaji
thousand	elfu
hunger	njaa
kalung	mkufu
akuntan	mhasibu
tabungan	akiba
ketenaran	umaarufu
peranti	kifaa
pencurian	wizi
malaria	malaria
millennium	milenia
keranjang	kikapu
keranjang	mkokoteni
konspirasi	njama
rekening	akaunti
rekening	hesabu
sugar	sukari
pelat	sahani
gemuk	mafuta
pure	safi
pujangga	mshairi
sum	jumla
konvoi	msafara
alergi	mzio
mangkuk	bakuli
resiko	hatari
gujarat	kigujarati
pembajakan	uharamia
pembajakan	udukuzi
eksploitasi	unyonyaji
corner	kona
sutera	hariri
proporsi	uwiano
edukasi	elimu
kemarin	jana
trip	safari
keraguan	shaka
chicken	kuku
idea	wazo
ketebalan	unene
penghalang	kizuizi
menyalahkan	lawama
menyalahkan	laumiwa
betis	ndama
kelelahan	uchovu
psikolog	mwanasaikolojia
silent	kimya
honey	asali
truck	lori
mentega	siagi
berlimpah	wingi
berlimpah	jaa
berlimpah	tele
siput	konokono
mauritania	mauritania
tersenyum	tabasamu
taxi	teksi
hikmat	hekima
bertengkar	fitina
bertengkar	ugomvi
akurasi	usahihi
daughter	binti
melangkah	hatua
beam	boriti
injeksi	sindano
evening	jioni
helicopter	helikopta
advokat	mtetezi
porsi	sehemu
sheng	sheng
weapon	silaha
inchi	inchi
batuk	kikohozi
warning	onyo
simpul	fundo
telephone	simu
though	ingawa
integritas	uadilifu
sedekah	sadaka
sentimeter	sentimita
bodi	mwili
lelang	mnada
fax	faksi
lightning	umeme
soldier	askari
burundi	burundi
itik	bata
hitung	hesabu
hitung	kadiri
kompensasi	fidia
senyum	tabasamu
menghina	matusi
menghina	tusi
hook	ndoano
berkah	baraka
jebakan	mtego
battery	betri
martabat	heshima
vagina	uke
vagina	ramani
seperempat	robo
twenty	ishirini
kesempurnaan	ukamilifu
pondasi	msingi
demon	pepo
penahanan	kizuizini
marmer	marumaru
clean	safi
ready	tayari
inch	inchi
sendok	kijiko
foot	mguu
pojok	kona
jus	juisi
homoseksualitas	ushoga
sapu	ufagio
sapu	fagia
witch	mchawi
cave	pango
kolonialisme	ukoloni
urin	mkojo
hosea	hosea
dinar	dinari
mulus	laini
minute	dakika
rabbit	sungura
choir	kwaya
fever	homa
delima	komamanga
diakon	shemasi
astronot	mwanaanga
fondasi	msingi
tiup	pigo
ask	uliza
hurricane	kimbunga
esok	kesho
graduate	mhitimu
patrol	doria
pembedahan	upasuaji
dirty	chafu
cycle	mzunguko
sunat	tohara
mile	maili
ark	safina
enemy	adui
marriage	ndoa
treasure	hazina
clock	saa
darkness	giza
kewirausahaan	ujasiriamali
anus	mkundu
gampang	rahisi
gambia	gambia
kemandirian	uhuru
antartika	antaktika
kriket	kriketi
sand	mchanga
cube	mchemraba
terminologi	istilahi
pipi	shavu
keledai	punda
acre	ekari
trinitas	utatu
traktor	trekta
emergency	dharura
parfum	manukato
insulin	insulini
sejuta	milioni
manifesto	ilani
judi	kamari
lapar	njaa
tabut	safina
berbohong	uongo
berbohong	danganywa
simpanse	sokwe
betlehem	bethlehemu
kecurigaan	tuhuma
pneumonia	nimonia
nafas	pumzi
oli	mafuta
gulf	ghuba
penabur	mpanzi
herbal	mitishamba
dedaunan	majani
terompet	tarumbeta
terompet	pembe
pembaptisan	ubatizo
naked	uchi
hundred	mia
soda	soda
pengkhotbah	mhubiri
nabati	mboga
quarter	robo
alphabet	alfabeti
hammer	nyundo
esther	esta
stick	fimbo
sample	sampuli
penghakiman	hukumu
parish	parokia
rugbi	raga
sintaks	sintaksia
dibelakang	nyuma
shepherd	mchungaji
egg	yai
milimeter	milimita
cuka	siki
ceres	ceres
owl	bundi
soap	sabuni
bag	mfuko
ozon	ozoni
sushi	sushi
kubis	kabichi
keong	konokono
wire	waya
raid	uvamizi
bed	kitanda
pertengkaran	fitina
pertengkaran	ugomvi
penolong	msaidizi
kebohongan	uongo
keterbukaan	uwazi
kesepian	upweke
kesepian	pweke
calling	wito
keringat	jasho
crow	kunguru
privasi	faragha
busa	povu
ranjang	kitanda
trap	mtego
vena	mshipa
corinthians	wakorintho
etiopia	ethiopia
etiopia	mhabeshi
belt	ukanda
wortel	karoti
kemeja	shati
cricket	kriketi
ketepatan	usahihi
stranger	mgeni
promise	ahadi
keimanan	imani
projek	mradi
grammar	sarufi
flame	moto
rekam	rekodi
patch	kiraka
kasur	godoro
cotton	pamba
tebusan	fidia
literal	halisi
scorer	mfungaji
bantal	mto
elevator	lifti
rezeki	riziki
rezeki	posho
carpenter	seremala
kecemasan	wasiwasi
psychology	saikolojia
tax	kodi
puting	chuchu
epilepsi	kifafa
selimut	blanketi
hunting	uwindaji
semantik	semantiki
besok	kesho
ketenagakerjaan	ajira
dagu	kidevu
kediktatoran	udikteta
emansipasi	ukombozi
prostitusi	ukahaba
prostitusi	malaya
roof	paa
yesterday	jana
pembengkakan	uvimbe
kelimpahan	wingi
geisha	geisha
cambuk	mjeledi
kalbu	moyo
frog	chura
perjudian	kamari
biskuit	biskuti
pig	nguruwe
buih	povu
pesulap	mchawi
embun	umande
kuartal	robo
bohong	uongo
bohong	mlongo
kreatifitas	ubunifu
mediator	mpatanishi
colonel	kanali
penjarahan	uporaji
penjarahan	nyara
cake	keki
kuping	sikio
forty	arobaini
nose	pua
leopard	chui
kompor	jiko
peluit	filimbi
penatua	mzee
quote	nukuu
ngengat	nondo
kelangkaan	uhaba
feminin	kike
amarah	hasira
amarah	ghadhabu
derita	mateso
tribe	kabila
insentif	motisha
kebodohan	ujinga
sembah	ibada
kait	mlima
kait	ndoano
kafilah	msafara
barber	kinyozi
lem	gundi
pelacuran	ukahaba
polis	sera
banana	ndizi
kelistrikan	umeme
ordinary	kawaida
katun	pamba
lengket	nata
impuls	msukumo
rembulan	mwezi
fonetik	fonetiki
kancing	kitufe
ember	kaa
ember	ndoo
rear	nyuma
galon	galoni
juice	juisi
sheep	kondoo
penghematan	akiba
taste	ladha
kekekalan	milele
silk	hariri
kearifan	hekima
amplop	bahasha
karantina	karantini
thirty	thelathini
garpu	uma
keakuratan	usahihi
sodium	sodiamu
kalkun	uturuki
coin	sarafu
blow	pigo
torch	mwenge
entrepreneur	mjasiriamali
mahakuasa	mwenyezi
rerumputan	nyasi
ingatlah	kumbuka
notebook	daftari
rubber	mpira
janggut	ndevu
accounting	uhasibu
husband	mume
bayam	mchicha
kondom	kondomu
kerudung	pazia
kerudung	boneti
gendut	mafuta
meniup	pigo
menggiring	ufugaji
rayap	mchwa
klorin	klorini
surplus	ziada
pyramid	piramidi
fifty	hamsini
supervisor	msimamizi
musafir	msafara
musafir	msafiri
merica	pilipili
jeremiah	yeremia
penjahit	mshonaji
cheese	jibini
sawi	haradali
kolera	kipindupindu
bucket	ndoo
ticket	tiketi
liur	mate
pelelangan	mnada
filemon	filemoni
tanyakan	uliza
pipe	bomba
madness	wazimu
meat	nyama
tuesday	jumanne
sifilis	kaswende
jude	yuda
penghapus	kifutio
ginger	tangawizi
kehangatan	joto
jenggot	ndevu
smooth	laini
habakuk	habakuki
dimanapun	popote
venom	sumu
plastic	plastiki
cobalah	jaribu
suntikan	sindano
kecacatan	dosari
kecacatan	ulemavu
kelalaian	zembe
kelalaian	uzembe
kelalaian	zembea
kuk	nira
berpatroli	doria
liver	ini
ruam	upele
rangkuman	muhtasari
fill	jaza
mentimun	tango
knife	kisu
kelereng	marumaru
prakiraan	utabiri
kecemburuan	wivu
diluar	nje
marble	marumaru